111111111111111111111111111111
1E0000000011111111111111111111
1000C0111011111111111111111111
1000000C0111111111111111111111
10000001P011111111111111111111
111111111111111111111111111111
111111111111111111111111111111