11111
10001
10EC1
1P011
11111
