11111111111
1E000000001
1000C000011
1000000C011
10000001P01
11111111111